10 10
0 0 0
8 1 0
3 1 1 3 1 1 1 1 1 2
2 0 0 1 2 0 0 0 0 2
2 0 3 2 2 0 0 2 0 2
2 1 2 2 2 0 0 2 0 2
2 0 0 0 0 0 0 2 0 2
3 1 0 1 1 1 1 2 0 2
2 0 0 0 0 0 0 1 1 2
2 0 0 0 0 0 0 1 10 2
2 0 0 0 0 0 0 0 2 2
1 1 1 1 1 1 1 1 1 0

3 1 1 1 1 1 1 1 1 2
2 0 0 0 0 0 0 0 10 2
2 0 0 0 0 0 0 0 2 2
2 0 0 0 0 0 0 0 2 2
2 0 0 0 0 0 0 0 2 2
2 0 0 0 0 0 0 0 2 2
2 0 0 0 0 0 0 0 2 2
2 0 0 0 0 0 0 0 2 2
2 0 0 0 0 0 0 0 2 2
1 1 1 1 1 1 1 1 1 0
