7 5 7 5 2
6 4 4 2 2
7 4 4 2 2
2 1 0 0 2
0 1 1 1 0
5