10 10
103	101	101	101	101	101	3	1	1	1
202	200	200	1	1	102	2	0	0	0
2	0	0	0	0	1	0	0	0	0
2	0	0	0	0	0	0	0	0	0
2	0	0	0	0	0	0	0	0	0
2	0	0	0	0	0	0	0	0	0
2	0	0	0	0	0	0	0	0	0
2	0	0	0	0	0	0	0	0	0
2	0	0	0	0	0	0	0	0	0
2	0	0	0	0	0	0	0	0	0
2	0	0	0	0	0	0	0	0	0
