10 10
3	1	1	1	1	1	1	1	1	1
2	11	0	0	0	0	0	0	0	0
2	0	4	0	0	0	0	0	0	0
2	0	0	0	0	0	0	0	0	0
2	0	0	0	9	0	0	0	0	0
2	0	0	0	0	0	0	0	0	0
2	0	0	0	0	0	0	0	0	0
2	0	0	0	0	0	0	0	0	0
2	0	0	0	0	0	0	0	0	0
2	0	0	0	0	0	0	0	0	0
